111111111111111111111111111111111111111111111111111111
1E1000000000000C00000C00000000000000000000000000000001
101001010010000010100100000001000000000000000000000101
101001001010101000100100000001000000000000000000000101
100000000C00C000000000000000000000000000000000000000C1
1000000000000000000000000000000000000000000000000000C1
1000000000000000000000000000000000000000000000000000C1
1000000000000000000000000000000000000000000000000000C1
1000000000000000000000000000000000000000000000000000C1
1000000000000000000000000000000000000000000000000000C1
1000000000000000000000000001000000000000000000000000C1
1000000000000000000000000001000000000000000000000000C1
1000000000000000000000000001000000000000000000000000C1
1000000000000000000100000001000000000000000000000000C1
100000000000000000000000P001000000000000000000000000C1
1000000000000000000000100001000000000000000000000000C1
1000000000000000001000000000000000000000000000000000C1
1000000000000000000000000000000000000000000000000000C1
1000000000000000000000000000000000000000000000000000C1
10000000000000000010001000C0000000000000000000000000C1
1000000000000000000000000000000000000000000000000000C1
1000000000000000000000000000000000000000000000000000C1
1000000001000000000000000010000000000000000000000000C1
1000000001000000000000000000000000000000000000000000C1
1000000000100100010010000011110000000000000000000000C1
1000000000000000000000000000010000000000000000000000C1
1000000001000000000000000000010000000000000000000000C1
1000000001000000000000000000000000000000000000000000C1
111111111111111111111111111111111111111111111111111111